**********
*P       *
*        *
*        *
*        *
*        *
*        *
*   M   M*
*       G*
**********