**********
*P       *
*        *
*****    *
*   M    *
*        *
*   ******
*        *
*       G*
**********