*****************
*P              *
*               *
*             M *
*            ****
*               *
****            *
*              M*
*              G*
*****************